W W W W W W W W W W W W W W W W W W W
P P P P P P P P P P P P P P P P P P P
P P P P P P P P P P P P P P P P P P P
P P P P P P P P P P P P P P P P P P P
P P P P P P P P P P P P P P P P P P P
P P P P P P P P P P P P P P P P P P P
P P 4 P P P P P P P P P P P P P P P P
P P P P P P P P P P P P P P P P P P P
P P P P P P P P P P P P P P P P P P P
P P P P P P P P P P P P P P P P P P P
P P P P P P P P P P P P P P P P P P P
P P P P P P P P P P P P P P P P P P P
P P P P P P P P P P P P P P P P P P P
P P P P P P P P P P P P P P P P P P P
P P P P P P P P P P P P P P P P P P P
P P P P P P P P P P P P P P P P P P P
P P P P P P P P P P P P P P P P P P P
P P P P P P P P P P P P P P P P P P P
P P P P P P P P P P P P P P P P P P P
P P P P P P P P P P P P P P P P 1 P P
W W W W W W W W W W W W W W W W W W W