W W W W W W W W W W W W W W W W W W W
W 1 S S S S S S S W S S S S S S S 2 W
W B W W S W W W W W W W W W S W W B W
W S S S S S S S S S S S S S S S S S W
W S W W S W S W W W W W S W S W W S W
W S S S S W S S S W S S S W S S S S W
W W W W S W W W E W E W W W S W W W W
E E E W S W E E E E E E E W S W E E E
W W W W S W E W E W E W E W S W W W W
E E E E S E E W E P E W E E S E E E E
W W W W S W E W W W W W E W S W W W W
E E E W S W E E E E E E E W S W E E E
W W W W S W E W W W W W E W S W W W W
W S S S S S S S S W S S S S S S S S W
W B W W S W W W W W W W W W S W W B W
W S S W S S S S S S S S S S S W S S W
W W S W S W S W W W W W S W S W S W W
W S S S S W S S S W S S S W S S S S W
W S W W W W W W S W S W W W W W W S W
W 3 S S S S S S S S S S S S S S S 4 W
W W W W W W W W W W W W W W W W W W W