W W W W W W W W W W W W W W W W W W W
W 1 S S S S S S S S S S S S S S S 2 W
W S W S W S W S W B W W W W W W W W W
W S S S W S W S W S S S S S S S S S W
W S W S W S W W W W W S W S W W W S W
W S W S W S S S S S W S W S S S W B W
W S W W W S W S W W W S W W W S W W W
W S S S S S W S S S W S S S W S S S W
W S W W W S W P W S W W W S W W W W W
W S S S W S S S W S S S W S S S S S W
W S W W W W W W W S W S W W W S W S W
W S S S S B S S S S W S S S W S W S W
W S W S W W W S W S W S W W W W W W W
W B W S S S S S W S W S S S S S S S W
W S W W W W W W W S W W W S W S W S W
W S S S S S S S W S S S S S W S W S W
W S W W W S W S W W W S W S W S W W W
W S S S W S W S S S S S W S W S S S W
W S W S W S W W W W W W W W W W W S W
W 3 W S W S S S S S S S S S S S S 4 W
W W W W W W W W W W W W W W W W W W W